%%%%%%%%%%%%%%%%%%%%%%%%%%%%%%%%%%%%%%
%P...                                %
%   .                                %
%   .                        ...     %
%   .                       .     .  %
%   .                       .     .  %
%   .... .....           ..          %
%            .                    .  %
%            .          .            %
%            .          .            %
%            .          .         .  %
%                       .            %
%            .                       %
%            .                    .  %
%            .          .            %
%            .          .            %
%                   .          ...   %
%                           .        %
%            .                       %
%            .     .                 %
%            .     .         .       %
%            .     .            .    %
%            .     .                 %
%            .                       %
%            .                 .     %
%   ..  .....      .        .        %
% .                .                 %
% .                .                 %
% .       .......                    %
% .      .                           %
%        .                           %
%  ....                              %
%                                    %
%                                    %
%%%%%%%%%%%%%%%%%%%%%%%%%%%%%%%%%%%%%%
